Astracantha_aurea	W
Astracantha_bethlehemitica	W
Astracantha_caucasica	W
Astracantha_cerasocrena	W
Astracantha_cretica	B
Astracantha_deinacantha	W
Astracantha_denudata	W
Astracantha_diphtherites	W
Astracantha_granatensis	BA
Astracantha_gummifera	W
Astracantha_karabaghensis	W
Astracantha_microcephala	W
Astracantha_oleifolia	W
Astracantha_parnassi	B
Astracantha_plumosa	W
Astracantha_pterocephala	W
Astracantha_stenonychioides	W
Astracantha_strobilifera	W
Astragalus_abbreviatus	W
Astragalus_abnormalis	W
Astragalus_aboriginum	N
Astragalus_acaulis	E
Astragalus_accidens	N
Astragalus_accumbens	NS
Astragalus_achundovii	W
Astragalus_ackerbergensis	W
Astragalus_ackermanii	N
Astragalus_acmophylloides	W
Astragalus_acutifolius	W
Astragalus_acutirostris	N
Astragalus_adanus	N
Astragalus_adpressipilosus	W
Astragalus_adsurgens	N
Astragalus_adulterinus	W
Astragalus_aduncus	W
Astragalus_adzharicus	W
Astragalus_aegobromus	W
Astragalus_aeluropus	W
Astragalus_aequalis	N
Astragalus_agameticus	W
Astragalus_agnicidus	N
Astragalus_agraniotii	B
Astragalus_agrestis	N
Astragalus_ajfreidii	W
Astragalus_ajubensis	W
Astragalus_akkensis	A
Astragalus_aksaricus	WN
Astragalus_aksuensis	WE
Astragalus_alaicus	W
Astragalus_alamliensis	W
Astragalus_alaschanus	E
Astragalus_alatavicus	W
Astragalus_albens	N
Astragalus_albertii	W
Astragalus_albertoregelia	W
Astragalus_albicaulis	WB
Astragalus_albulus	N
Astragalus_aleppicus	W
Astragalus_alexandrii	W
Astragalus_algarbiensis	AB
Astragalus_algerianus	AN
Astragalus_allochrous	N
Astragalus_aloisii	E
Astragalus_alopecias	W
Astragalus_alopecuroides	BA
Astragalus_alopecurus	WB
Astragalus_alpamarcae	S
Astragalus_alpinus	BNEWU
Astragalus_altaicola	W
Astragalus_altimurensis	E
Astragalus_altus	N
Astragalus_alvordensis	N
Astragalus_alyssoides	W
Astragalus_amarus	W
Astragalus_amatus	S
Astragalus_amblytropis	N
Astragalus_americanus	N
Astragalus_amherstianus	WE
Astragalus_ammodendroides	W
Astragalus_ammodendron	W
Astragalus_ammodytes	B
Astragalus_ammotrophus	W
Astragalus_amnis-amissi	N
Astragalus_amphioxys	N
Astragalus_ampullarioides	N
Astragalus_ampullarius	N
Astragalus_anacardius	W
Astragalus_ancistrocarpus	W
Astragalus_andaulgensis	W
Astragalus_andersonii	N
Astragalus_anemophilus	N
Astragalus_anfractuosus	W
Astragalus_angarensis	BW
Astragalus_angreni	W
Astragalus_angustatus	W
Astragalus_angustiflorus	BW
Astragalus_angustifolius	WB
Astragalus_anisacanthus	EW
Astragalus_anisomerus	WN
Astragalus_anisus	N
Astragalus_ankylotus	B
Astragalus_anni-novi	S
Astragalus_annularis	WA
Astragalus_anserinifolius	W
Astragalus_anserinus	N
Astragalus_antheliophorus	W
Astragalus_anthosphaerus	W
Astragalus_anxius	N
Astragalus_apollineus	B
Astragalus_applegatii	N
Astragalus_aqrabatensis	W
Astragalus_aquilanus	B
Astragalus_aquilonius	N
Astragalus_arbelicus	W
Astragalus_arbuscula	W
Astragalus_archibaldii	W
Astragalus_arcuatus	W
Astragalus_arenarius	BW
Astragalus_arequipensis	S
Astragalus_arganaticus	W
Astragalus_argentinus	S
Astragalus_argophyllus	N
Astragalus_arguricus	W
Astragalus_argutensis	W
Astragalus_argyroides	W
Astragalus_aridus	N
Astragalus_arizonicus	N
Astragalus_arkalycensis	W
Astragalus_armatus	A
Astragalus_armeniacus	W
Astragalus_arnoldii	EW
Astragalus_arnottianus	S
Astragalus_arrectus	N
Astragalus_arthurii	N
Astragalus_aschuturi	N
Astragalus_asclepiadoides	N
Astragalus_askius	W
Astragalus_asper	BW
Astragalus_aspindzicus	W
Astragalus_asplundii	S
Astragalus_aspreticola	W
Astragalus_asterias	WAB
Astragalus_asymmetricus	N
Astragalus_atratus	N
Astragalus_atricapillus	W
Astragalus_atropilosulus	AW
Astragalus_atropubescens	N
Astragalus_atropurpureus	WN
Astragalus_atrovinosus	W
Astragalus_atwoodii	N
Astragalus_aucheri	W
Astragalus_auratus	W
Astragalus_austinae	N
Astragalus_austiniae	N
Astragalus_australis	NBA
Astragalus_austriacus	BW
Astragalus_austroaegaeus	B
Astragalus_austroargentinus	S
Astragalus_austrosibiricus	WB
Astragalus_avicennicus	W
Astragalus_baba-alliar	W
Astragalus_bachmarensis	W
Astragalus_badamensis	W
Astragalus_baionensis	B
Astragalus_baissunensis	W
Astragalus_baitagensis	W
Astragalus_bakaliensis	W
Astragalus_bakuensis	W
Astragalus_balchaschensis	W
Astragalus_balearicus	B
Astragalus_balfourianus	E
Astragalus_barbatus	WA
Astragalus_barnebyi	N
Astragalus_bashgalensis	E
Astragalus_bashmensis	W
Astragalus_basiflorus	W
Astragalus_basineri	W
Astragalus_batangensis	E
Astragalus_bazmanicus	W
Astragalus_beathii	N
Astragalus_beatleyae	N
Astragalus_beckerianus	WB
Astragalus_beckii	W
Astragalus_beckwithii	N
Astragalus_beketowi	W
Astragalus_bellus	S
Astragalus_bergii	S
Astragalus_bernardinus	N
Astragalus_berteri	W
Astragalus_berterianus	S
Astragalus_bezudensis	WE
Astragalus_bhotanensis	E
Astragalus_bibullatus	N
Astragalus_bicolor	W
Astragalus_bicristatus	N
Astragalus_bidentatus	S
Astragalus_biebersteinii	W
Astragalus_bifidus	B
Astragalus_biovulatus	W
Astragalus_bisulcatus	N
Astragalus_bodinii	N
Astragalus_boelckei	S
Astragalus_boeticus	BAW
Astragalus_bolanderi	N
Astragalus_bombycinus	W
Astragalus_bonariensis	S
Astragalus_bornmuellerianus	W
Astragalus_borodinii	W
Astragalus_borraginaceus	W
Astragalus_bossuensis	W
Astragalus_bounophilus	W
Astragalus_bourgaeanus	AB
Astragalus_bourgovii	N
Astragalus_bowes-lyonii	E
Astragalus_brachybotrys	W
Astragalus_brachycarpus	W
Astragalus_brachycentrus	W
Astragalus_brachylobus	WB
Astragalus_brachyodontus	W
Astragalus_brachypetalus	W
Astragalus_brachypus	W
Astragalus_brachystachys	W
Astragalus_brachytropis	W
Astragalus_brackenridgei	S
Astragalus_bracteosus	W
Astragalus_brahuicus	E
Astragalus_brandegeei	N
Astragalus_brandegei	N
Astragalus_brauntonii	N
Astragalus_brazoensis	N
Astragalus_brevialatus	E
Astragalus_brevidens	W
Astragalus_brevifolius	WE
Astragalus_brevipes	W
Astragalus_breviscapus	WE
Astragalus_breweri	N
Astragalus_bryantii	N
Astragalus_buchtormensis	WB
Astragalus_bungeanus	W
Astragalus_burkartii	S
Astragalus_buschiorum	W
Astragalus_bustillosii	SW
Astragalus_cachinalensis	S
Astragalus_caeruleopetalinus	E
Astragalus_calamistratus	W
Astragalus_californicus	N
Astragalus_callichrous	W
Astragalus_calliphysa	W
Astragalus_callistachys	W
Astragalus_callithrix	N
Astragalus_calycinus	W
Astragalus_calycosus	N
Astragalus_camelorum	W
Astragalus_camptoceras	W
Astragalus_camptodontoides	E
Astragalus_camptopus	N
Astragalus_campylanthus	W
Astragalus_campylorhynchus	W
Astragalus_campylosema	W
Astragalus_campylotrichus	W
Astragalus_canadensis	N
Astragalus_cancellatus	W
Astragalus_canescens	W
Astragalus_canoflavus	W
Astragalus_capillipes	E
Astragalus_capito	W
Astragalus_caprinus	AWB
Astragalus_captiosus	W
Astragalus_caraganae	W
Astragalus_carduchorum	W
Astragalus_caricinus	N
Astragalus_carinatus	S
Astragalus_carmanicus	W
Astragalus_carminis	N
Astragalus_caroli-henrici	W
Astragalus_casapaltensis	S
Astragalus_casei	N
Astragalus_castaneiformis	N
Astragalus_castetteri	N
Astragalus_catabostrychos	W
Astragalus_cavanillesii	B
Astragalus_cenorrhynchus	N
Astragalus_centralis	W
Astragalus_cephalanthus	W
Astragalus_ceramicus	N
Astragalus_cerasinus	W
Astragalus_ceratoides	W
Astragalus_cerussatus	N
Astragalus_chaetodon	W
Astragalus_chaidamuensis	E
Astragalus_chalaranthus	W
Astragalus_chamaeleuce	N
Astragalus_chamaemeniscus	N
Astragalus_chamissonis	S
Astragalus_charadzeae	W
Astragalus_chardinii	W
Astragalus_charguschanus	EW
Astragalus_chilienshanensis	E
Astragalus_chinensis	EB
Astragalus_chingoanus	W
Astragalus_chionanthus	W
Astragalus_chionobiiformis	W
Astragalus_chiukiangensis	E
Astragalus_chiwensis	W
Astragalus_chloodes	N
Astragalus_chlorodontus	W
Astragalus_chlorostachys	EW
Astragalus_chlorostegius	W
Astragalus_chomutowii	W
Astragalus_chordorrhizus	W
Astragalus_chorinensis	WB
Astragalus_chorizanthus	E
Astragalus_chrysopterus	E
Astragalus_chrysostachys	W
Astragalus_chubutensis	S
Astragalus_chuskanus	N
Astragalus_cibarius	N
Astragalus_cicer	WB
Astragalus_ciceroides	W
Astragalus_cimae	N
Astragalus_cinereus	W
Astragalus_circumdatus	N
Astragalus_cisoxanus	W
Astragalus_citrinus	W
Astragalus_clandestinus	S
Astragalus_clarianus	N
Astragalus_clarkeanus	E
Astragalus_clerceanus	B
Astragalus_clevelandii	N
Astragalus_clusii	B
Astragalus_coahuilae	N
Astragalus_cobrensis	N
Astragalus_coccineus	N
Astragalus_cochabambensis	S
Astragalus_cognatus	W
Astragalus_colhuensis	S
Astragalus_collinus	N
Astragalus_coltonii	N
Astragalus_columbianus	N
Astragalus_coluteocarpus	EW
Astragalus_coluteopsis	W
Astragalus_commixtus	WE
Astragalus_comosus	W
Astragalus_complanatus	E
Astragalus_complicatus	S
Astragalus_compressus	W
Astragalus_concinnus	S
Astragalus_concretus	E
Astragalus_confertus	WE
Astragalus_confusus	W
Astragalus_congdonii	N
Astragalus_conjunctus	N
Astragalus_connectens	W
Astragalus_consanguineus	W
Astragalus_consobrinus	N
Astragalus_conspicuus	W
Astragalus_contortuplicatus	EWB
Astragalus_convallarius	N
Astragalus_coquimbensis	S
Astragalus_coriaceus	N
Astragalus_corniculatus	BW
Astragalus_cornutus	WB
Astragalus_coronilla	W
Astragalus_corrugatus	AWE
Astragalus_cottamii	N
Astragalus_cottonianus	W
Astragalus_cottonii	N
Astragalus_cracca	S
Astragalus_craibianus	E
Astragalus_crassicarpus	N
Astragalus_crassifolius	E
Astragalus_crassispinus	E
Astragalus_cremnophylax	N
Astragalus_crenatus	BAWE
Astragalus_cretaceus	W
Astragalus_cronquistii	N
Astragalus_crotalariae	N
Astragalus_cruckshanksii	S
Astragalus_crymophilus	S
Astragalus_cryptanthus	S
Astragalus_crypticus	S
Astragalus_cryptobotrys	S
Astragalus_cuatrecasasii	S
Astragalus_cuneifolius	W
Astragalus_curtipes	N
Astragalus_curvicarpus	N
Astragalus_curvicaulis	SW
Astragalus_curviflorus	W
Astragalus_curvipes	W
Astragalus_curvirostris	W
Astragalus_cuscutae	W
Astragalus_cusickii	N
Astragalus_cuyanus	S
Astragalus_cyaneus	N
Astragalus_cyclophyllon	W
Astragalus_cymbicarpos	BA
Astragalus_cymboides	N
Astragalus_cyri	W
Astragalus_cysticalyx	WN
Astragalus_cytisoides	W
Astragalus_dactylocarpus	W
Astragalus_daenaensis	W
Astragalus_daghestanicus	W
Astragalus_dahuricus	EWB
Astragalus_daleae	N
Astragalus_danicus	BW
Astragalus_darii	W
Astragalus_darumbium	S
Astragalus_darwinianus	S
Astragalus_dasyanthus	BW
Astragalus_davidii	E
Astragalus_deanei	N
Astragalus_debequaeus	N
Astragalus_degensis	E
Astragalus_dekazygus	W
Astragalus_demavendicolus	W
Astragalus_demavendicus	W
Astragalus_demetrii	W
Astragalus_deminutivus	S
Astragalus_dendroides	W
Astragalus_densiflorus	WE
Astragalus_denticulatus	W
Astragalus_depauperatus	WB
Astragalus_dependens	E
Astragalus_depressus	BWA
Astragalus_desereticus	N
Astragalus_desperatus	N
Astragalus_deterior	N
Astragalus_detritalis	N
Astragalus_dianthus	W
Astragalus_diaphanus	N
Astragalus_dictamnoides	W
Astragalus_dictyolobus	W
Astragalus_didymocarpus	N
Astragalus_dielsii	S
Astragalus_dignus	EW
Astragalus_dilutus	W
Astragalus_diminutivus	S
Astragalus_dingjiensis	E
Astragalus_diopogon	E
Astragalus_dipelta	WN
Astragalus_diphacus	N
Astragalus_discernendus	E
Astragalus_discolor	E
Astragalus_distinens	S
Astragalus_distortus	N
Astragalus_diversifolius	N
Astragalus_djilgensis	W
Astragalus_dodtii	S
Astragalus_dolichophyllus	W
Astragalus_dombeyi	W
Astragalus_domeykoanus	S
Astragalus_donianus	EB
Astragalus_douglasii	N
Astragalus_drabelliformis	N
Astragalus_drummondii	N
Astragalus_drupaceus	B
Astragalus_dschangartensis	WE
Astragalus_duanensis	W
Astragalus_duchesnensis	N
Astragalus_dulungkiangensis	E
Astragalus_dumetorum	E
Astragalus_durandianus	W
Astragalus_dzebrailicus	W
Astragalus_eastwoodiae	N
Astragalus_ebenoides	W
Astragalus_ecbatanus	W
Astragalus_echinatus	BA
Astragalus_echinops	W
Astragalus_edmondsonii	W
Astragalus_edmondstonei	WS
Astragalus_edulis	BA
Astragalus_effusus	W
Astragalus_efoliatus	E
Astragalus_egglestonii	N
Astragalus_elatior	W
Astragalus_ellipsoideus	W
Astragalus_elymaiticus	W
Astragalus_emarginatus	W
Astragalus_emoryanus	N
Astragalus_endytanthus	W
Astragalus_englerianus	E
Astragalus_ensifer	W
Astragalus_ensiformis	N
Astragalus_epiglottis	BAW
Astragalus_episcopus	N
Astragalus_equisolensis	N
Astragalus_eremiticus	N
Astragalus_eremophilus	WA
Astragalus_eriocarpus	W
Astragalus_erionotus	WE
Astragalus_eriopodus	W
Astragalus_eriostomus	W
Astragalus_erivanensis	W
Astragalus_ernestii	E
Astragalus_ertterae	N
Astragalus_erubescens	W
Astragalus_ervoides	N
Astragalus_erwinii-gaubae	W
Astragalus_erythrolepis	W
Astragalus_erythrosemius	EW
Astragalus_esperanzae	N
Astragalus_euchlorus	E
Astragalus_eucosmus	NB
Astragalus_eugenii	W
Astragalus_eupeplus	N
Astragalus_eurekensis	N
Astragalus_eurylobus	N
Astragalus_eusarathron	W
Astragalus_exasperatus	W
Astragalus_exscapus	WB
Astragalus_fabaceus	W
Astragalus_fabrisii	S
Astragalus_falcatus	WNB
Astragalus_falciformis	NA
Astragalus_falcigerus	W
Astragalus_falconeri	EW
Astragalus_famatinae	S
Astragalus_fangensis	E
Astragalus_fastidius	N
Astragalus_faurei	A
Astragalus_fedtschenkoanus	W
Astragalus_feensis	N
Astragalus_fenzelianus	E
Astragalus_ferganensis	W
Astragalus_fialae	BW
Astragalus_filicaulis	WE
Astragalus_filiformis	BEW
Astragalus_filipes	N
Astragalus_firuzkuhensis	W
Astragalus_fissuralis	W
Astragalus_flavocreatus	S
Astragalus_flavus	N
Astragalus_flexicaulis	W
Astragalus_flexuosus	N
Astragalus_flexus	W
Astragalus_floridulus	E
Astragalus_floridus	E
Astragalus_follicularis	W
Astragalus_forrestii	E
Astragalus_fragiferus	W
Astragalus_fragrans	W
Astragalus_francisquitensis	N
Astragalus_franziskae	W
Astragalus_fraxinifolius	WN
Astragalus_freitagii	W
Astragalus_freynii	W
Astragalus_frickii	W
Astragalus_fridae	W
Astragalus_frigidus	BW
Astragalus_froedinii	A
Astragalus_fruticosus	WB
Astragalus_fucatus	N
Astragalus_fuhsii	W
Astragalus_fuliginosus	W
Astragalus_funereus	N
Astragalus_galactites	EBW
Astragalus_galegiformis	W
Astragalus_galiifolius	W
Astragalus_gambelianus	N
Astragalus_garbancillo	S
Astragalus_gaubae	W
Astragalus_gebleri	BWN
Astragalus_geminiflorus	S
Astragalus_geniculatus	A
Astragalus_gentryi	N
Astragalus_georgii	W
Astragalus_germaini	S
Astragalus_geyeri	N
Astragalus_gibbsii	N
Astragalus_giganteus	N
Astragalus_gilensis	N
Astragalus_gilgitensis	E
Astragalus_gilmanii	N
Astragalus_glabellus	N
Astragalus_gladiatus	B
Astragalus_glaucacanthos	W
Astragalus_glaucus	WB
Astragalus_glaux	BA
Astragalus_globiceps	W
Astragalus_glomeratus	B
Astragalus_glumaceus	W
Astragalus_glycyphylloides	BW
Astragalus_glycyphyllos	BWN
Astragalus_goktschaicus	W
Astragalus_goldmanii	N
Astragalus_golmuensis	E
Astragalus_gombo	A
Astragalus_gompholobium	W
Astragalus_goniatus	N
Astragalus_gorczakovskii	B
Astragalus_gorodkovii	B
Astragalus_gracilidentatus	W
Astragalus_gracilipes	WE
Astragalus_gracilis	N
Astragalus_graecus	B
Astragalus_grahamianus	E
Astragalus_grammocalyx	W
Astragalus_granitovii	W
Astragalus_graveolens	WE
Astragalus_grayi	N
Astragalus_greggii	N
Astragalus_griffithii	W
Astragalus_griseus	W
Astragalus_groetzbachii	W
Astragalus_grubovii	EW
Astragalus_gruinus	N
Astragalus_guatemalensis	N
Astragalus_gudrunensis	W
Astragalus_gueldenstaedtiae	W
Astragalus_guttatus	WB
Astragalus_gymnopodus	W
Astragalus_gypsodes	N
Astragalus_habamontis	E
Astragalus_haesitabundus	W
Astragalus_hajastanus	W
Astragalus_hallii	N
Astragalus_hamiltonii	N
Astragalus_hamosus	WBA
Astragalus_hamrinensis	W
Astragalus_hancockii	B
Astragalus_handelii	E
Astragalus_harbisonii	N
Astragalus_harpilobus	WA
Astragalus_harpocarpus	W
Astragalus_harringtonii	N
Astragalus_harrisonii	N
Astragalus_hartmanii	N
Astragalus_hartwegii	N
Astragalus_hauarensis	WA
Astragalus_havianus	E
Astragalus_helleri	N
Astragalus_helmii	BW
Astragalus_hemiphaca	W
Astragalus_hemsleyi	W
Astragalus_henryi	E
Astragalus_heptapotamicus	W
Astragalus_herbertii	W
Astragalus_heterodontus	WE
Astragalus_heydei	E
Astragalus_hidalgensis	N
Astragalus_himalayanus	E
Astragalus_hintonii	N
Astragalus_hirsutus	W
Astragalus_hirtus	W
Astragalus_hispanicus	B
Astragalus_hispidulus	WA
Astragalus_hoantchy	E
Astragalus_hoffmeisteri	EW
Astragalus_hohenackeri	W
Astragalus_holmgreniorum	N
Astragalus_hololeios	W
Astragalus_hololeucoides	W
Astragalus_holophyllus	W
Astragalus_holosemius	W
Astragalus_hoodianus	N
Astragalus_hornii	N
Astragalus_horridus	W
Astragalus_howellii	N
Astragalus_huiningensis	E
Astragalus_humifusus	WB
Astragalus_humilis	W
Astragalus_humillimus	N
Astragalus_humistratus	N
Astragalus_huthianus	W
Astragalus_hyalolepis	W
Astragalus_hymenocalyx	W
Astragalus_hymenocystis	W
Astragalus_hymenostegis	W
Astragalus_hypogaeus	W
Astragalus_hypoglottis	BA
Astragalus_hypoleucus	N
Astragalus_hypoxylus	N
Astragalus_hypsogenus	S
Astragalus_hyrcanus	W
Astragalus_ibrahimianus	A
Astragalus_icmadophilus	W
Astragalus_idaeus	B
Astragalus_idrietorum	N
Astragalus_iljinii	W
Astragalus_illinii	S
Astragalus_imitensis	E
Astragalus_impexus	W
Astragalus_inaequalifolius	WN
Astragalus_incanus	BA
Astragalus_incertus	W
Astragalus_infestus	WE
Astragalus_inflexus	N
Astragalus_inopinatus	WB
Astragalus_insularis	N
Astragalus_intarrensis	W
Astragalus_intercedens	W
Astragalus_inversus	N
Astragalus_inyoensis	N
Astragalus_iodanthus	N
Astragalus_iodopetalus	N
Astragalus_ionae	W
Astragalus_irinaea	W
Astragalus_iselyi	N
Astragalus_ishigensis	B
Astragalus_ishkamishensis	W
Astragalus_isphairamicus	W
Astragalus_jabbor-khailii	W
Astragalus_jaegerianus	N
Astragalus_jagnobicus	W
Astragalus_jaliscensis	N
Astragalus_jaxarticus	W
Astragalus_jejunus	N
Astragalus_jesdianus	W
Astragalus_jessenii	W
Astragalus_jiuquanensis	E
Astragalus_jodostachys	W
Astragalus_jodotropis	W
Astragalus_joergensenii	S
Astragalus_johannis-howellii	N
Astragalus_johannis	W
Astragalus_johnstonii	E
Astragalus_jolderensis	W
Astragalus_junatovii	E
Astragalus_juratzkanus	W
Astragalus_kabadianus	W
Astragalus_kaghysmani	W
Astragalus_kahiricus	WAE
Astragalus_karakugensis	W
Astragalus_karelinianus	BW
Astragalus_karkarensis	W
Astragalus_kashmirensis	E
Astragalus_kaufmannii	WB
Astragalus_kavirensis	W
Astragalus_kazbeki	W
Astragalus_kentrophyta	N
Astragalus_kerkukiensis	W
Astragalus_kermanschahensis	W
Astragalus_kerrii	N
Astragalus_kessleri	W
Astragalus_khaneradarensis	W
Astragalus_khasianus	E
Astragalus_khoshjailensis	W
Astragalus_khwaja-muhammadensis	W
Astragalus_kialensis	E
Astragalus_kifonsanicus	E
Astragalus_kirilovii	W
Astragalus_kirpicznikovii	W
Astragalus_kirrindicus	W
Astragalus_knightii	N
Astragalus_kohrudicus	W
Astragalus_kolymensis	B
Astragalus_korovinianus	N
Astragalus_kralikii	A
Astragalus_kronenburgii	W
Astragalus_kudrjaschovii	W
Astragalus_kungurensis	B
Astragalus_kunlunensis	W
Astragalus_kuramensis	EW
Astragalus_kurtschumensis	BW
Astragalus_kuschakewiczi	EW
Astragalus_kuschkensis	EW
Astragalus_kustanaicus	W
Astragalus_laccoliticus	N
Astragalus_lacei	E
Astragalus_laceratus	W
Astragalus_lacteus	B
Astragalus_laetus	W
Astragalus_lagopoides	W
Astragalus_laguriformis	W
Astragalus_laguroides	WB
Astragalus_lalesarensis	W
Astragalus_lambinonii	W
Astragalus_lamondiae	W
Astragalus_lancearius	N
Astragalus_lanuginosus	WN
Astragalus_laricus	W
Astragalus_lasioglottis	W
Astragalus_lasiopetalus	W
Astragalus_lasiophyllus	W
Astragalus_lasiosemius	WE
Astragalus_laspurensis	E
Astragalus_latifolius	EW
Astragalus_latiunguiculatus	E
Astragalus_laxmannii	NBWE
Astragalus_layneae	N
Astragalus_leansanicus	E
Astragalus_ledinghamii	W
Astragalus_legionensis	N
Astragalus_lehmannianus	W
Astragalus_leibergii	N
Astragalus_leiophyllus	W
Astragalus_leiosemius	W
Astragalus_lemmonii	N
Astragalus_lentiformis	N
Astragalus_lentiginosus	N
Astragalus_leontinus	B
Astragalus_lepsensis	W
Astragalus_leptaleus	N
Astragalus_leptocarpus	N
Astragalus_leptocaulis	W
Astragalus_leptophysus	W
Astragalus_leptus	WE
Astragalus_lessertioides	EA
Astragalus_leucocephalus	E
Astragalus_leucocladus	W
Astragalus_leucolobus	N
Astragalus_levieri	W
Astragalus_levitubus	E
Astragalus_licentianus	E
Astragalus_lilacinus	W
Astragalus_limariensis	S
Astragalus_limnocharis	N
Astragalus_limprichtii	EW
Astragalus_lindheimeri	N
Astragalus_lineatus	W
Astragalus_linifolius	N
Astragalus_lipskyi	W
Astragalus_lithophilus	W
Astragalus_littoralis	N
Astragalus_loanus	N
Astragalus_lonchocarpus	N
Astragalus_longidentatus	BA
Astragalus_longilobus	E
Astragalus_longipetalus	W
Astragalus_longipetiolatus	U
Astragalus_longissimus	N
Astragalus_longistipitatus	W
Astragalus_looseri	S
Astragalus_lorinserianus	W
Astragalus_lotiflorus	N
Astragalus_lucidus	E
Astragalus_lumsdenianus	W
Astragalus_lunatus	W
Astragalus_lupulinus	BW
Astragalus_lurorum	W
Astragalus_luteolus	E
Astragalus_lutosus	N
Astragalus_luxurians	W
Astragalus_lyallii	N
Astragalus_lycioides	W
Astragalus_lyonnetii	N
Astragalus_maassoumii	W
Astragalus_mackewiczii	W
Astragalus_macrobotrys	W
Astragalus_macrocephalus	W
Astragalus_macroceras	WB
Astragalus_macrodon	N
Astragalus_macronyx	W
Astragalus_macropelmatus	W
Astragalus_macropetalus	W
Astragalus_macropodium	W
Astragalus_macropterus	WE
Astragalus_macropus	WB
Astragalus_macrosemius	W
Astragalus_macrostachys	W
Astragalus_macrotrichus	W
Astragalus_macrotropis	WN
Astragalus_macrourus	W
Astragalus_magdalenae	N
Astragalus_magellanicus	S
Astragalus_mahoschanicus	EW
Astragalus_mailiensis	W
Astragalus_maireanus	A
Astragalus_majevskianus	W
Astragalus_malacoides	N
Astragalus_malacus	N
Astragalus_managildensis	W
Astragalus_mangeri	WE
Astragalus_manucehrii	W
Astragalus_mareoticus	A
Astragalus_marianus	N
Astragalus_marinus	BE
Astragalus_mario-sousae	N
Astragalus_maritimus	S
Astragalus_maroccanus	A
Astragalus_masenderanus	W
Astragalus_matiensis	E
Astragalus_mattam	E
Astragalus_maurorum	A
Astragalus_maurus	A
Astragalus_maximowiczii	W
Astragalus_maxwellii	E
Astragalus_mayeri	B
Astragalus_medius	WN
Astragalus_megacarpus	N
Astragalus_megalanthus	W
Astragalus_megalocystis	W
Astragalus_megalomerus	WN
Astragalus_megricus	W
Astragalus_meiliensis	E
Astragalus_melanocalyx	N
Astragalus_melanochiton	W
Astragalus_melanodon	W
Astragalus_melanostachys	WE
Astragalus_melilotoides	EWB
Astragalus_mendocinus	S
Astragalus_mercklinii	WE
Astragalus_mesites	S
Astragalus_michauxii	N
Astragalus_micrancistrus	W
Astragalus_micranthellus	S
Astragalus_micranthus	N
Astragalus_microcymbus	N
Astragalus_microcystis	N
Astragalus_microdontus	NE
Astragalus_micromerius	N
Astragalus_microphysa	W
Astragalus_miguelensis	N
Astragalus_mikrophyton	W
Astragalus_miniatus	BWE
Astragalus_minimus	S
Astragalus_minthorniae	N
Astragalus_minutissimus	WS
Astragalus_minutulus	W
Astragalus_mirabilis	E
Astragalus_misellus	N
Astragalus_miser	N
Astragalus_missouriensis	N
Astragalus_miyalomontis	E
Astragalus_moellendorffii	E
Astragalus_moencoppensis	N
Astragalus_mohavensis	N
Astragalus_mokiacensis	N
Astragalus_molestus	W
Astragalus_mollissimus	N
Astragalus_molybdenus	N
Astragalus_monadelphus	E
Astragalus_monanthemus	W
Astragalus_monbeigii	E
Astragalus_mongholicus	WBE
Astragalus_monoensis	N
Astragalus_monspessulanus	BAW
Astragalus_monticola	S
Astragalus_montigenus	E
Astragalus_monumentalis	N
Astragalus_moranii	N
Astragalus_mossulensis	W
Astragalus_moyanoi	S
Astragalus_mucidus	WB
Astragalus_mucronifolius	W
Astragalus_muelleri	B
Astragalus_mulfordiae	N
Astragalus_muliensis	E
Astragalus_multiceps	E
Astragalus_multijugus	W
Astragalus_munroi	E
Astragalus_murinus	W
Astragalus_musimonum	N
Astragalus_musiniensis	N
Astragalus_myrianthus	W
Astragalus_naftabensis	W
Astragalus_naturitensis	N
Astragalus_neglectus	N
Astragalus_nelidae	S
Astragalus_nelsonianus	N
Astragalus_nematodes	W
Astragalus_neobarnebyanus	S
Astragalus_neoburkartianus	S
Astragalus_neocarpus	S
Astragalus_neolipskyanus	W
Astragalus_neomexicanus	N
Astragalus_nephtonensis	W
Astragalus_neuquenensis	S
Astragalus_neurophyllus	W
Astragalus_newberryi	N
Astragalus_nidularius	N
Astragalus_nigricalycis	N
Astragalus_nigriceps	W
Astragalus_nigrivestitus	W
Astragalus_nigrolineatus	W
Astragalus_nitens	W
Astragalus_nitidiflorus	B
Astragalus_nivalis	WE
Astragalus_nivicola	S
Astragalus_nobilis	W
Astragalus_norvegicus	B
Astragalus_nothoxys	N
Astragalus_noziensis	E
Astragalus_nuciferus	W
Astragalus_nudisiliquus	N
Astragalus_nudus	N
Astragalus_nummularius	WB
Astragalus_nurensis	W
Astragalus_nutans	N
Astragalus_nutriosensis	N
Astragalus_nuttallianus	N
Astragalus_nuttallii	N
Astragalus_nutzotinensis	N
Astragalus_nyensis	N
Astragalus_obcordatus	N
Astragalus_obscurus	N
Astragalus_ochreatus	W
Astragalus_ochrochlorus	W
Astragalus_ochroleucus	S
Astragalus_odoratus	WB
Astragalus_oihorensis	E
Astragalus_olchonensis	B
Astragalus_olgae	W
Astragalus_oligophyllus	W
Astragalus_oncotrichus	W
Astragalus_oniciformis	N
Astragalus_onobrychioides	WB
Astragalus_onobrychis	WBAN
Astragalus_oocalycis	N
Astragalus_oocarpus	N
Astragalus_oocephalus	W
Astragalus_oophorus	N
Astragalus_ophiocarpus	EW
Astragalus_oplites	E
Astragalus_orbicularifolius	E
Astragalus_orbiculatus	W
Astragalus_orcuttianus	N
Astragalus_ordubadensis	W
Astragalus_oreades	W
Astragalus_oreganus	N
Astragalus_ornithopodioides	W
Astragalus_ornithorrhynchus	W
Astragalus_oroproselius	W
Astragalus_orthocarpoides	W
Astragalus_orthocarpus	S
Astragalus_ortholobus	W
Astragalus_osterhoutii	N
Astragalus_ovatus	W
Astragalus_ovigerus	W
Astragalus_ovoideus	W
Astragalus_owirensis	E
Astragalus_oxyglottis	WBA
Astragalus_oxyodon	E
Astragalus_oxyphysopsis	N
Astragalus_oxyphysus	N
Astragalus_oxypterus	W
Astragalus_oxyrhynchus	N
Astragalus_pachypus	N
Astragalus_pachyrhizus	W
Astragalus_pakistanicus	E
Astragalus_paktiensis	E
Astragalus_palenae	S
Astragalus_palibinii	WB
Astragalus_pallescens	WB
Astragalus_palmeri	N
Astragalus_pamirensis	EW
Astragalus_panamintensis	N
Astragalus_panduratus	W
Astragalus_paposanus	S
Astragalus_paradoxus	W
Astragalus_paralipomenus	W
Astragalus_paralurges	W
Astragalus_paraplesius	W
Astragalus_pardalinus	N
Astragalus_parodii	S
Astragalus_parryi	N
Astragalus_parvicarinatus	W
Astragalus_parvus	N
Astragalus_parwanicus	W
Astragalus_patagonicus	S
Astragalus_pattersonii	N
Astragalus_paucijugus	W
Astragalus_pauper	W
Astragalus_pauperculus	N
Astragalus_pauperiflorus	W
Astragalus_pauranthus	S
Astragalus_pavlovii	E
Astragalus_paysonii	N
Astragalus_peckii	N
Astragalus_pectinatus	N
Astragalus_peduncularis	WE
Astragalus_pehuenches	WSN
Astragalus_pelecinus	BA
Astragalus_pellitus	W
Astragalus_peltatus	W
Astragalus_penduliflorus	B
Astragalus_pendulinus	W
Astragalus_pennellianus	N
Astragalus_perdurans	W
Astragalus_peregrinus	AWB
Astragalus_perianus	N
Astragalus_persepolitanus	WE
Astragalus_persicus	W
Astragalus_peruvianus	S
Astragalus_peterae	WE
Astragalus_peterfii	B
Astragalus_petraeus	W
Astragalus_petropolitanus	N
Astragalus_phlomoides	W
Astragalus_phoenix	N
Astragalus_physocarpus	W
Astragalus_physodes	W
Astragalus_pictiformis	N
Astragalus_piletocladus	W
Astragalus_pinetorum	W
Astragalus_pinonis	N
Astragalus_piptocephalus	W
Astragalus_piscator	N
Astragalus_piscinus	N
Astragalus_pissisi	S
Astragalus_piutensis	N
Astragalus_plagiophacos	W
Astragalus_plattensis	N
Astragalus_platyphyllus	W
Astragalus_platysematus	W
Astragalus_platytropis	N
Astragalus_plumbeus	N
Astragalus_podlechii	W
Astragalus_podocarpus	WA
Astragalus_podolobus	W
Astragalus_polaris	NB
Astragalus_poliotrichus	W
Astragalus_politovii	W
Astragalus_polozhiae	W
Astragalus_polyacanthus	E
Astragalus_polyceras	W
Astragalus_polycladus	ENW
Astragalus_polygala	W
Astragalus_polyphyllus	W
Astragalus_pomonensis	N
Astragalus_ponticus	WB
Astragalus_popovii	W
Astragalus_porphyrocalyx	E
Astragalus_porphyrophysa	W
Astragalus_porrectus	N
Astragalus_potosinus	N
Astragalus_praelongus	N
Astragalus_prattii	E
Astragalus_preussii	N
Astragalus_prilipkoanus	W
Astragalus_pringlei	N
Astragalus_propinquus	BWNE
Astragalus_prorifer	N
Astragalus_proximus	N
Astragalus_przewalskii	E
Astragalus_pseudoadsurgens	B
Astragalus_pseudoamygdalinus	W
Astragalus_pseudoaustralis	W
Astragalus_pseudoborodinii	W
Astragalus_pseudobrachystachys	W
Astragalus_pseudochlorostachys	E
Astragalus_pseudocyclophyllus	W
Astragalus_pseudocytisoides	W
Astragalus_pseudofragiferus	W
Astragalus_pseudohypogaeus	W
Astragalus_pseudoindurascens	W
Astragalus_pseudojohannis	W
Astragalus_pseudokurrumensis	W
Astragalus_pseudomegalomerus	W
Astragalus_pseudomultijugus	W
Astragalus_pseudonobilis	W
Astragalus_pseudotesticulatus	W
Astragalus_pseudoutriger	W
Astragalus_pseudoversicolor	E
Astragalus_psilacanthus	WE
Astragalus_psilocentros	E
Astragalus_psilolobus	W
Astragalus_pterocarpus	N
Astragalus_ptychophyllus	W
Astragalus_pubentissimus	N
Astragalus_puberulus	W
Astragalus_pueblae	N
Astragalus_pulcher	W
Astragalus_pullus	E
Astragalus_pulsiferae	N
Astragalus_pulviniformis	S
Astragalus_punae	S
Astragalus_punctatus	W
Astragalus_puniceus	N
Astragalus_purpurascens	E
Astragalus_purpusii	N
Astragalus_purshii	N
Astragalus_pushtashanicus	W
Astragalus_pusillus	S
Astragalus_pycnostachyus	N
Astragalus_pyrrhotrichus	EW
Astragalus_quinqueflorus	N
Astragalus_quinquefoliolatus	W
Astragalus_quinquejugus	W
Astragalus_racemosus	N
Astragalus_raddei	W
Astragalus_radicans	N
Astragalus_rafaelensis	N
Astragalus_rahensis	W
Astragalus_raphiodontus	W
Astragalus_rattanii	N
Astragalus_ravenii	N
Astragalus_rawianus	W
Astragalus_rawlinsianus	W
Astragalus_recognitus	W
Astragalus_recurvus	N
Astragalus_reduncus	W
Astragalus_reesei	A
Astragalus_reflexistipulus	E
Astragalus_reflexus	N
Astragalus_regiomontanus	N
Astragalus_registanicus	W
Astragalus_reichei	W
Astragalus_reinii	A
Astragalus_remotiflorus	W
Astragalus_remotijugus	W
Astragalus_remotus	N
Astragalus_retamocarpus	W
Astragalus_reticulatus	W
Astragalus_retusifoliatus	E
Astragalus_reuterianus	W
Astragalus_reventiformis	N
Astragalus_reventus	N
Astragalus_rhacodes	W
Astragalus_rhizanthus	EW
Astragalus_rhizocephalus	EW
Astragalus_rhodosemius	W
Astragalus_richii	SA
Astragalus_rigidulus	EA
Astragalus_rimarum	W
Astragalus_riouxii	W
Astragalus_riparius	N
Astragalus_ripleyi	N
Astragalus_robbinsii	N
Astragalus_robustus	W
Astragalus_rosae	W
Astragalus_rosellus	W
Astragalus_roseus	B
Astragalus_rostratus	W
Astragalus_rubriflorus	W
Astragalus_rubrolineatus	W
Astragalus_rufescens	W
Astragalus_ruiz-lealii	S
Astragalus_rupifragus	WB
Astragalus_rusbyi	N
Astragalus_ruscifolius	W
Astragalus_rytidocarpus	W
Astragalus_rytilobus	W
Astragalus_rzaevii	W
Astragalus_sabuletorum	BW
Astragalus_sabulonum	N
Astragalus_sabulosus	N
Astragalus_saccatus	W
Astragalus_sachalinensis	B
Astragalus_sachanewii	W
Astragalus_saetiger	W
Astragalus_saganlugensis	W
Astragalus_sahendi	W
Astragalus_salatavicus	W
Astragalus_salmonis	N
Astragalus_salsugineus	W
Astragalus_sanandajianus	W
Astragalus_sanctae-crucis	S
Astragalus_sanctorum	N
Astragalus_sanczirii	W
Astragalus_sangimashensis	W
Astragalus_sangonensis	W
Astragalus_sanguineus	N
Astragalus_sanguinolentus	W
Astragalus_saralensis	WB
Astragalus_sarbasnensis	W
Astragalus_sardaimionensis	N
Astragalus_satoi	E
Astragalus_saurinus	N
Astragalus_savellanicus	W
Astragalus_saxifractor	WE
Astragalus_saxorum	E
Astragalus_scaberrimus	EWB
Astragalus_scabrisetus	W
Astragalus_scalaris	N
Astragalus_scaphoides	N
Astragalus_schahrudensis	W
Astragalus_schanginianus	W
Astragalus_schelichowii	BE
Astragalus_scheremetevianus	WE
Astragalus_schimperi	WA
Astragalus_schinetorum	S
Astragalus_schistocalyx	W
Astragalus_schistosus	W
Astragalus_schizotropis	A
Astragalus_schmalhausenii	W
Astragalus_schmidii	W
Astragalus_schmolliae	N
Astragalus_schrenkianus	WN
Astragalus_schugnanicus	WE
Astragalus_sciureus	W
Astragalus_sclerocarpus	N
Astragalus_scleroxylon	W
Astragalus_scoparius	W
Astragalus_scopulorum	N
Astragalus_scorpioides	BWA
Astragalus_scorpiurus	EW
Astragalus_scutaneus	N
Astragalus_secundus	E
Astragalus_sedaensis	E
Astragalus_seidabadensis	W
Astragalus_semicircularis	E
Astragalus_semilunatus	W
Astragalus_semnanensis	W
Astragalus_sempervirens	BA
Astragalus_sepultipes	N
Astragalus_serenoi	N
Astragalus_sericeocanus	B
Astragalus_sericopetalus	W
Astragalus_sericophyllus	B
Astragalus_serpens	N
Astragalus_sesameus	BA
Astragalus_sesamoides	W
Astragalus_sesquiflorus	N
Astragalus_setosulus	W
Astragalus_sevangensis	W
Astragalus_severzovii	WEN
Astragalus_shagalensis	W
Astragalus_sharestanicus	W
Astragalus_shatuensis	W
Astragalus_sheldonii	N
Astragalus_shelkovnikovii	W
Astragalus_shevockii	N
Astragalus_shinanensis	BE
Astragalus_shiroumensis	E
Astragalus_shortianus	N
Astragalus_shultziorum	N
Astragalus_siahderrensis	W
Astragalus_sieberi	W
Astragalus_sieversianus	W
Astragalus_sikkimensis	E
Astragalus_sikokianus	E
Astragalus_siliceus	N
Astragalus_siliquosus	W
Astragalus_simplicifolius	N
Astragalus_simpsonii	E
Astragalus_sinaicus	ABW
Astragalus_sinaloae	N
Astragalus_sinicus	E
Astragalus_sinuatus	N
Astragalus_sirinicus	B
Astragalus_skythropos	E
Astragalus_smithianus	E
Astragalus_sogdianus	W
Astragalus_solandri	A
Astragalus_solitarius	N
Astragalus_somcheticus	W
Astragalus_sommieri	W
Astragalus_sophoroides	N
Astragalus_souliei	E
Astragalus_soxmaniorum	N
Astragalus_spaldingii	N
Astragalus_sparsiflorus	N
Astragalus_sparsus	W
Astragalus_spartioides	W
Astragalus_spatulatus	N
Astragalus_speciosus	W
Astragalus_spegazzinii	S
Astragalus_speirocarpus	N
Astragalus_sphaeranthus	W
Astragalus_sphaerocystis	W
Astragalus_spinescens	W
Astragalus_spinosus	WA
Astragalus_sprucei	S
Astragalus_spruneri	BW
Astragalus_squarrosus	WE
Astragalus_stalinskyi	W
Astragalus_stapfii	W
Astragalus_stella	BA
Astragalus_stenanthus	W
Astragalus_stenoceras	WE
Astragalus_stenocystis	W
Astragalus_stenolepis	W
Astragalus_stepporum	W
Astragalus_sterilis	N
Astragalus_stevenianus	BWEN
Astragalus_stewartii	AE
Astragalus_stipitatus	W
Astragalus_stipulatus	E
Astragalus_stocksii	W
Astragalus_straturensis	N
Astragalus_straussii	W
Astragalus_striatiflorus	N
Astragalus_strictilobus	W
Astragalus_strictus	EW
Astragalus_strigosostipulatus	W
Astragalus_strigulosus	N
Astragalus_subalpinus	W
Astragalus_subarcuatus	W
Astragalus_subcinereus	N
Astragalus_suberosus	BWA
Astragalus_submaculatus	W
Astragalus_submitis	W
Astragalus_subrosulariformis	W
Astragalus_subsecundus	W
Astragalus_substipitatus	W
Astragalus_subuliformis	WB
Astragalus_subumbellatus	EW
Astragalus_subverticillatus	W
Astragalus_subvestitus	N
Astragalus_succumbens	N
Astragalus_suffruticosus	WB
Astragalus_sulcatus	WB
Astragalus_sulfuratus	W
Astragalus_sumbari	W
Astragalus_sungpanensis	E
Astragalus_supervisus	W
Astragalus_supinus	W
Astragalus_suprapilosus	W
Astragalus_susianus	W
Astragalus_sutchuenensis	E
Astragalus_syreitschikovii	W
Astragalus_szovitsii	W
Astragalus_tabrisianus	W
Astragalus_taipaishanensis	E
Astragalus_taiyuanensis	E
Astragalus_takharensis	W
Astragalus_takhtadzhjanii	W
Astragalus_tamiricus	E
Astragalus_tanaiticus	W
Astragalus_tanguticus	E
Astragalus_taochius	W
Astragalus_tarijensis	S
Astragalus_tarumensis	W
Astragalus_taschkendicus	W
Astragalus_tashqurghanicus	W
Astragalus_tataricus	E
Astragalus_tatsienensis	E
Astragalus_taubertianus	A
Astragalus_tawilicus	W
Astragalus_tegetarioides	N
Astragalus_teheranicus	W
Astragalus_tehuelches	S
Astragalus_temirensis	WB
Astragalus_tenellus	N
Astragalus_tener	N
Astragalus_tennesseensis	N
Astragalus_tenuifolius	A
Astragalus_tephrodes	N
Astragalus_tephrolobus	W
Astragalus_tephrosioides	W
Astragalus_termeanus	W
Astragalus_terminalis	N
Astragalus_terracianoi	B
Astragalus_terrestris	E
Astragalus_testiculatus	WB
Astragalus_tetrapterus	N
Astragalus_thermensis	B
Astragalus_thomsonii	E
Astragalus_thurberi	N
Astragalus_tibetanus	WE
Astragalus_tidestromii	N
Astragalus_tiehmii	N
Astragalus_tigridis	W
Astragalus_tioides	N
Astragalus_titanophilus	N
Astragalus_titovii	W
Astragalus_toanus	N
Astragalus_toksunensis	W
Astragalus_tolmaczevii	B
Astragalus_tolucanus	N
Astragalus_tongolensis	E
Astragalus_toquimanus	N
Astragalus_tortipes	N
Astragalus_tortuosus	W
Astragalus_trachoniticus	W
Astragalus_tragacantha	BW
Astragalus_traskiae	N
Astragalus_tremolsianus	B
Astragalus_tribulifolius	E
Astragalus_tribuloides	AcE
Astragalus_tricarinatus	N
Astragalus_trichanthus	W
Astragalus_trichocarpus	E
Astragalus_tricholobus	W
Astragalus_trichopodus	N
Astragalus_triflorus	S
Astragalus_trigonocarpus	B
Astragalus_trigonus	A
Astragalus_trimestris	W
Astragalus_triradiatus	W
Astragalus_troglodytus	N
Astragalus_tschujensis	W
Astragalus_tugarinovii	BN
Astragalus_tulinovii	E
Astragalus_tumninensis	B
Astragalus_tungensis	E
Astragalus_tupalangi	W
Astragalus_turbinatus	W
Astragalus_turczaninowii	WN
Astragalus_turolensis	B
Astragalus_tweedyi	N
Astragalus_tyghensis	N
Astragalus_ufraensis	W
Astragalus_ugamicus	WN
Astragalus_uliginosus	BEW
Astragalus_ulothrix	W
Astragalus_umbellatus	NB
Astragalus_umbraticus	N
Astragalus_uncialis	N
Astragalus_uniflorus	S
Astragalus_unifoliolatus	W
Astragalus_uraniolimneus	W
Astragalus_urbanianus	S
Astragalus_urceolatus	N
Astragalus_urmiensis	W
Astragalus_utahensis	N
Astragalus_utriger	W
Astragalus_vaccarum	N
Astragalus_vaginatus	BW
Astragalus_vagus	S
Astragalus_valerianensis	N
Astragalus_vallaris	N
Astragalus_vallicola	B
Astragalus_valparadisiensis	S
Astragalus_vanillae	W
Astragalus_variabilis	E
Astragalus_variegatus	WB
Astragalus_varius	WB
Astragalus_varus	S
Astragalus_varzobicus	W
Astragalus_vavilovii	W
Astragalus_vegetus	W
Astragalus_venturii	S
Astragalus_veresczaginii	W
Astragalus_vereskensis	W
Astragalus_verrucosus	B
Astragalus_versicolor	BWE
Astragalus_verticillatus	S
Astragalus_verus	WE
Astragalus_vesicarius	BW
Astragalus_vesiculosus	S
Astragalus_vessalae	W
Astragalus_vexillaris	W
Astragalus_vexilliflexus	N
Astragalus_vicarius	W
Astragalus_villosissimus	W
Astragalus_villosus	N
Astragalus_viridis	W
Astragalus_vogelii	WA
Astragalus_vulcanicus	W
Astragalus_vulpinus	W
Astragalus_wagneri	W
Astragalus_wardii	N
Astragalus_waterfallii	N
Astragalus_webberi	N
Astragalus_webbianus	WE
Astragalus_weberbaueri	S
Astragalus_weddellianus	SW
Astragalus_weixinensis	E
Astragalus_welshii	N
Astragalus_wenquanensis	E
Astragalus_wenxianensis	E
Astragalus_werdermannii	S
Astragalus_wetherillii	N
Astragalus_whitneyi	N
Astragalus_williamsii	N
Astragalus_wilmottianus	B
Astragalus_wingatanus	N
Astragalus_wittmannii	N
Astragalus_wolgensis	BW
Astragalus_woodruffii	N
Astragalus_wootonii	N
Astragalus_wrightii	N
Astragalus_xanthomeloides	WN
Astragalus_xanthotrichus	W
Astragalus_xanthoxiphidiopsis	EW
Astragalus_xiphidium	W
Astragalus_xiphoides	N
Astragalus_xipholobus	W
Astragalus_xylobasis	W
Astragalus_yangtzeanus	E
Astragalus_yoder-williamsii	N
Astragalus_yumenensis	E
Astragalus_yunnanensis	E
Astragalus_zacatecanus	N
Astragalus_zagrosicus	W
Astragalus_zanskarensis	E
Astragalus_zayuensis	E
Astragalus_zerdanus	W
Astragalus_zingeri	BW
Astragalus_zionis	N
Astragalus_zohrabi	W
Carmichaelia_violacea	U
Clianthus_puniceus	NUS
Colutea_abyssinica	A
Eremosparton_flaccidum	W
Erophaca_baetica	BWA
Hedysarum_boreale	NB
Lessertia_capitata	A
Onobrychis_conferta	B
Oxytropis_aciphylla	EW
Oxytropis_adamsiana	B
Oxytropis_albana	W
Oxytropis_arctica	NB
Oxytropis_aucheri	WE
Oxytropis_besseyi	N
Oxytropis_bicolor	E
Oxytropis_campanulata	WB
Oxytropis_campestris	NB
Oxytropis_chionobia	WE
Oxytropis_ciliata	E
Oxytropis_coerulea	EWB
Oxytropis_czukotica	B
Oxytropis_deflexa	NBWE
Oxytropis_eriocarpa	W
Oxytropis_exserta	B
Oxytropis_falcata	E
Oxytropis_grandiflora	EWB
Oxytropis_hirta	E
Oxytropis_humifusa	EW
Oxytropis_immersa	WE
Oxytropis_jacquinii	B
Oxytropis_jonesii	N
Oxytropis_jordalii	N
Oxytropis_kansuensis	E
Oxytropis_kobukensis	N
Oxytropis_koyukukensis	N
Oxytropis_lagopus	N
Oxytropis_lambertii	N
Oxytropis_lapponica	BW
Oxytropis_macrocarpa	W
Oxytropis_maydelliana	NB
Oxytropis_melanocalyx	E
Oxytropis_mertensiana	NB
Oxytropis_microphylla	EWB
Oxytropis_mollis	E
Oxytropis_multiceps	N
Oxytropis_nana	N
Oxytropis_neglecta	B
Oxytropis_nigrescens	NBE
Oxytropis_nutans	W
Oxytropis_obnapiformis	N
Oxytropis_ochotensis	B
Oxytropis_ochrantha	E
Oxytropis_ochrocephala	E
Oxytropis_ochroleuca	E
Oxytropis_oreophila	N
Oxytropis_oxyphylloides	B
Oxytropis_parryi	N
Oxytropis_pauciflora	EW
Oxytropis_pilosa	WB
Oxytropis_poncinsii	EW
Oxytropis_qinghaiensis	E
Oxytropis_racemosa	E
Oxytropis_recognita	W
Oxytropis_riparia	N
Oxytropis_savellanica	W
Oxytropis_scammaniana	NB
Oxytropis_sericea	N
Oxytropis_splendens	N
Oxytropis_squammulosa	WBE
Oxytropis_strobilacea	WBE
Oxytropis_talassica	W
Oxytropis_taochensis	E
Oxytropis_tianschanica	W
Oxytropis_vassilczenkoi	B
Oxytropis_viscida	N
Oxytropis_williamsii	E
Oxytropis_yunnanensis	E
Phyllolobium_tribulifolium	E
Smirnowia_turkestana	W
Sphaerophysa_salsula	NWEB
Sutherlandia_microphylla	A
Swainsona_formosa	U
Tragacantha_densifolia	W
Tragacantha_fasciculifolia	W
Wisteria_sinensis	NBEUASW
